********
*.#O****
*..OO.**
*..**#**
**..*..*
**#....*
**P.****
********