*******
***.P**
***.#**
*.##O**
*.#OO.*
*.#OO.*
*...***
*******