*****
*O.P*
*O#.*
*.#.*
*.#O*
*****